TST = "countries/Test.txt"
TS2 = "countries/Test2.txt"
NAG = "countries/Naga.txt"
GAD = "countries/Gamaldon.txt"
APO = "countries/AnarchyProklatiiOstrov.txt"
ROI = "countries/Roi.txt"
IPO = "countries/ImperiaProklatiiOstrov.txt"
FIS = "countries/Fish.txt"
CHI = "countries/China.txt"
HAB = "countries/Habvits.txt"
PIR = "countries/Pirates.txt"
IND = "countries/Indea.txt"
TEG = "countries/Tegort.txt"
MAD = "countries/Madastar.txt"
ZMK = "countries/ZmeinoeKorolevstvo.txt"
IEL = "countries/Ielf.txt"
DRE = "countries/Drenei.txt"
LAD = "countries/LizardAdministratum.txt"
BKJ = "countries/BeastKontinentJungle.txt"
KTR = "countries/BloodTrolls.txt"
MLA = "countries/MoonLizards.txt"
HLI = "countries/HloroInsects.txt"
JTR = "countries/JungleTrolls.txt"
JDR = "countries/JungleDragons.txt"
SRD = "countries/SteamRoad.txt"
WEL = "countries/WhaterElementals.txt"
FEL = "countries/FireElementals.txt"
ITL = "countries/Italia.txt"
PLD = "countries/Portland.txt"
AVR = "countries/Averia.txt"
NAV = "countries/Navegatum.txt"
CNF = "countries/ConfederationBalmoria.txt"
BBT = "countries/Triada.txt"
BBM = "countries/Mungiki.txt"
BBB = "countries/Burov's Bratva.txt"
BEC = "countries/El Cartel.txt"
FSR = "countries/Free Sailors' Republic.txt"
OCL = "countries/Osington Colony.txt"
FCL = "countries/Fransesia Colony.txt"
OCL = "countries/Osington Colony.txt"
ICL = "countries/Italia Colony.txt"
PCL = "countries/Portland Colony.txt"
PCL = "countries/Coast Kingdom Colony.txt"
KCL = "countries/Konfederation Colony.txt"
ACL = "countries/Averia Colony.txt"
CCL = "countries/Coast Kingdom Colony.txt"
CKL = "countries/Coast Kingdom Colony.txt"
RCL = "countries/Rossland Colony.txt"
VNL = "countries/Vennla.txt"
ARM = "countries/Argentum.txt"
BET = "countries/Bello-Tosto.txt"
TRC = "countries/Travel City.txt"
ORS = "countries/Order State.txt"
NAC = "countries/Navegatum Colony.txt"
ITR = "countries/Ingri tribe.txt"
MTR = "countries/Mana tribe.txt"
STR = "countries/Soera tribe.txt"
MIR = "countries/Mi tribe.txt"
HTR = "countries/Haru Tribe.txt"
COB = "countries/ColdenBurg.txt"
OAS = "countries/Oasis.txt"
EPI = "countries/Epiovia.txt"
NMY = "countries/Nemey.txt"
NUG = "countries/Nugmia.txt"
SRA = "countries/Sifria.txt"
KRF = "countries/Karfa.txt"
LND = "countries/Lunda.txt"
MRV = "countries/Maraviania.txt"
HIM = "countries/Himyart Kingdom.txt"
SAB = "countries/Sabaria Kingdom.txt"
DGP = "countries/Dogport.txt"
DMT = "countries/Dewmount.txt"
IST = "countries/Ironsummit.txt"
EMF = "countries/Emberfrost.txt"
ASP = "countries/Arrowspell.txt"
DKC = "countries/Duskcrest.txt"
BRZ = "countries/Bronzemere.txt"
FPT = "countries/Free Province of Tsalbia.txt"
CSA = "countries/Costotica.txt"
MBA = "countries/Malbrusha.txt"
LIS = "countries/Lorka Island.txt"
IIS = "countries/Independet Island.txt"
FLY = "countries/Flyghtright.txt"
REY = "countries/Reytan Pirates.txt"
QIO = "countries/Qioltian tribal council.txt"
HIG = "countries/Commune of Hig.txt"
KHA = "countries/Commune of Hig.txt"
NIF = "countries/Nifar trade republic.txt"
AUR = "countries/Aur republic.txt"
EVO = "countries/Vo's Eskimos.txt"
EGO = "countries/Go's Eskimos.txt"
RAV = "countries/Raviol'.txt"
HAR = "countries/Harbit Republic.txt"
ROM = "countries/Roma.txt"
FRA = "countries/Francesia.txt"
DOM = "countries/Domisia.txt"
BBC = "countries/Beasts_BladeContinent.txt"
PTB = "countries/Princedom_Tikblang.txt"
TLE = "countries/Torg_league.txt"
KKU = "countries/Kingdom_Khon.txt"
GIL = "countries/Government_Ilton.txt"
KNO = "countries/Klck_Noobin.txt"
TGU = "countries/TimeGovernment_Uson.txt"
KTH = "countries/Konfederation_Tribe_Nohuman.txt"
GTU = "countries/Government_Turiel.txt"
KAN = "countries/Klick_Ansan.txt"
KUV = "countries/Klick_Uviet.txt"
KLS = "countries/Klick_LonSon.txt"
NIM = "countries/Nimland.txt"
OSI = "countries/Osington.txt"
VIA = "countries/Vicia.txt"
TOS = "countries/Talos.txt"
CKB = "countries/Cold_k_beasts.txt"
AMZ = "countries/Amalzuk.txt"
AGA = "countries/Agnia.txt"
FSE = "countries/Fireside.txt"
PRS = "countries/Prasia.txt"
KLM = "countries/Kingdom of Lombi.txt"
KSO = "countries/Kingdom of Spolero.txt"
KTO = "countries/Kingdom of Toskan.txt"
KSM = "countries/Kingdom of Salem.txt"
MYO = "countries/Myonneria.txt"
ICR = "countries/Imperial Center.txt"
STH = "countries/Southern Movat.txt"
SKT = "countries/Speckom.txt"